##....#..#####...#######...##.#..####.###.##..###.####.#....##.##.##.#.#####.#.#.#..##.#...#.##.##.#...###.####..###..##.#.#.#....#.#.#..##.....#.##.#.....#..###...##...#####.##.#..#.....#.#.#.#.#.####.###...###..####..#....###..######....####.#..##.##.###.#..#.#.#.###..#.##...#.###.##.#.###.#...#...#....###.##...#.#####.#..#.##..#.##..###.#...###...#######.#.......#...##........######.#########..##.##...##.#...####.....#####....#######..#..###.#####..#.#......#.##..###.####..##...###.########..#.##..#..#..

.....#.#.##..##.##.#.###...#.#..#..###.#...#.#...####.###.....#..#.##...##.##.#.#.#.###.##.#...##.##
##..##...##..#..####.#.###....#.###..#..#.##......####..#.###...#####.#...#.##.###.###.##.##.##...##
.#..#.#.......#.#.#..#.#.#...###.###.###.###..#.##..##.###.##..#.#....##.#...#####..#..##..#####.##.
####.#######.##.#.....####..##...#.......#.###.##.###.###.#####..#.#######.#.#...#.#.#..####..#.#...
##.#.....##.#..#.#####.###.#.#..#.#..#.#.....###.#.##.#..#.###...#####..#..#.##...#.##......###.##..
#..####.######...#.#####.########.#.#..#.#..##.##..#.######.#..#...####.#.###.###..##..#.#.....###.#
...###..#.####.#..##..###....##....###.##.#...#..#..#..#...##.##.####...###.####.###..#.##.##..#..##
.#.#..#...#..###.####...##..#.#...#...##..####.#..#..#....#...##..#..#.##..##.#......#.###.###.#..#.
......##..#...#.....#.###....##...#.##...#....#..##..#..##..##..#...###############.#.####.###.##.#.
#####.##..#.#.#..#.#..###....#....#......#....##.#.##...##.##.#.#....#.##.##..##...####..##.....##..
#.#..#.##....#......##.###...#.##.#.##.#.#..######..#..##..####.#.#####..#.#..###....##..##.#.###.#.
.###.#####....#.#.###.####.......#.#.##.....###.##....#.#.#....#.##...###..#..#.##.#..##.#....#.#.##
..##...#####..####.####..##.###.#..#..######......##..###....##...#..#..#...#.##..##.####..#####..#.
.#..#.###..#.##..#.#.#.####.#..#.#..#..####.####..#.#..##..#.#....#.##.###..#.#####.#..#...###..#...
#.######..##.#.#.#..#..##....#.......#####.###.##.#.##..##.###..#.#...##.#.#...###.#..#..#....#.##.#
#..##.##..#....#.#.###...#.##.#.#.#.....###.##.###..##.#.....#..##.#...###.##.###########.#.#.#.#...
.##.########.###...####.....###....#.##...#..##..##.###......##.##.#.#.#...#...####...#.##...#..#.#.
##..#.#.#.####...##......#...##.....#.#.###....#.##.....#.#.##.#.########.#......#...##.##.#.#####.#
...#.#....##.###.#..####...##..##...#...###.###.#.###...##..#....##.##..#...#.#.#..##.###.##..#.##..
###.#.###..###.##..#....##.#..##.###.#....#......#######..#.#..#...###.#..##.###.##.#####.##..#.#.##
.#..##.#####..##.#..###.##.###.#.###.#....#.###.##.#.....#...#..#...###....#.#.####....##...........
.#.#..##.#.###.#....#.####.##..##.....#..###.#..#.#.#...#..#....####..#..#.#..###.##.#..####.####..#
##...###..##.######.#....#..#.#.###.###...##.##.#..####..#..####..##...##....####..#...##.#.#.###...
###.#...#..#.#..#..##.##.##..##.#####...#..##.#...##.#..#...##.####.#.##.##.#.##.#......###.#..#....
.....##.#...#.#.#.#...#.#.##.......#.#.######.#..#..##.##......#...#.###.#....###..#..#.##.##.##....
####..##.##...#.###..#...#.##.####.#..#.#..#.###..####.##.#..#..#.##...#####.#.###.##.###..#.##...#.
.##..#.#####.#.#....##.###..##..###.#.#.#.########.##..####.#.##...#.##.##.##.#.#....#.####.#....#.#
#####..#.#.#.####...#.......#.#..##....#.#.###.#..#.##.##.#.#..#....#..#######.#....#......#.####..#
.....###...##...####..#...###.##.#.#...#...#.#..#...#.##..#..#..###...####.#...#....#.##....###...#.
##.....##..#...##.#.#.###...#.###.###.#.#..#..##..##.#....#..#..#...####.#...#..#...##..###...##...#
#.#.##.##..##......##..####...#.##.####....##....####..##.#...###.#.##.#..###..#..###..###..#...#...
#.##..###.##.#..#####.#.##.##..###.#.##.....#.....#...#.....##.#..##..#....#.#..##...##.#.####.##...
..#.#.#.....##.#...#..#....##..##.##.##.#.#.##.#...####..#..#...###.#..##..##...#####.#...#.#...#.#.
.###.##.#.######..#.#..#...#.#...####.#..###.###..###.####.###..#...#.#...######..##......#..###...#
.#...#.#..#.###....#.##.####.########..###.#.#.#.#.###.#.#.##.##...######.#..#...#...#..#....##.####
###.#.#####..###..###.###...###.....#####.#...#.###.#...#..#..####...#.#..###..#.#.......#.....#..#.
.##.#.#..##..#..##..##.#.###.##.##..#.#.##.##.##.#####...###.##...#..##.##.#..##.#.#.###....##....#.
....##......#..##.###.##...#.######.#.#...#.###.######.#.####.....#.####.###....#..##..#.#.##.#...#.
..##.#.......#....#.#........#..#..#..#...#.#.####..#####....#.....##...##.....###.#.#..#.##..##...#
.#.###.###....#...#..###.#######..####.....#.##..#.#.#..##....#.##.#....#..#####.#..#.#######.#.#...
...#.....###.#...#.#####..#..#..#.##.##.#......###.#..#.##.##.####..##..###.....##..##.#.###...#.#.#
##...#.###.#.#.#.########.#.#.##..#.#..##....###.#..#.#........#.#......#.#.#...###...#.###.#.....##
##.#...#.##.#.###..#.#.#####.####..##....##.##....#.##.##.#.##..#..#...#...##.#####.##...#####..#...
..#..#..#####.#..#.#####..#..#......#.#......###..##..#..#.#..##.#####....####...#.##..#.##.#######.
.##.....#..#.##...#...#.###.#.####...##.#...###.#..###.....#..###..####...###...#...#...#...###.#.##
#.#####.##..#.##.###.....#.#####..#.#######...###.#####...#.###..#...#.....####..##..#.#..#..#.#.#.#
.##.###.##.#....#..###..###.##..####..#.....####.##.#..#.##.###...#.....#.####.##....#.#....#.##.#.#
#.#..########...#.#.##....##.#.#..##.#..#.#.#.##...#..##....######.#..##.#...#.#....##.#.##..##..#..
.##..#.##.##...####....#.##..####..##.##..#...#...#...######.#..##.#.....#.#......####...####...####
#..###..#.######...#...#..##.#....#..#..#####....#.####.#.#..###...#.####..#..####..##.##...#..#.#.#
#####.#.#.##..#....#.##.##.###...#.#.#.##..######.#.#...#.#.##.....##.###..#..##..#...#.#....###.#..
#..##.##.###.##..##.#.#.##.##..###.#..##.###...##.####.##..#.....##...##.#.######.###.##..###....##.
#.##....###..#..##.###.#...#.####.......#....##..#.#####..#.#.###########.##.##..#..##.#......######
###.##.###.##.#####..####.#####....#..##.###.....#..#.#.#..#.#.##..#.###..#..###..##.#####...#.#.#.#
#.####.....#.#.##..######......##.#..#.##.##.###..####..##..##.##.#.##.#.#.#..##..#.###.####..##..##
.....#...###...#...###.#.###.#.###.##.#.#...##.#.#..#..##..###.#..#.##..##..#.##..#.#.#.#.#...#.#.##
##..#####....#.##.#..##.##.....##....###..###...####....#..##..#..#.##.#.#.#.#.....#.##.....##..###.
######.#.##.###.#.#..##.#.##.##.....#.##..##.#..#...##.####..##.##..##...###.#......#####.....###.#.
.#..#.###.#..###.#.#.##..##..###....#.#..###.##.#.##..###...###...##.##.###...#..##.###....######...
##..#...#....#.#####..##.####...#...###........###..#...#.#.#.##....#..#.#...###.....###......####.#
.#..##..##...##..#...###..##.####.##.#..#.#.#....##.##...#....###...###.##.#####.##.#...##.####....#
......#....#####...####.##..#.##....###..#.#..#.....####.#...##..##..#.####...##..#..##.#.#.....####
##..##.##.#####.#.####..###.##.###..#...##..#.#.#....#######....#...#...###.######....#####.##.#...#
#.#.####..#.##..##.###.#.#...#.#......##.###...####...#.##...#.#.#...#.#.##..##...#...##...###.#####
##....#.#######...##...#....#.##.#..#...##..#.#.#####.###.###.#.#..##.###..##.###.#.#.##.....#..##.#
#.#.#.#...#..##.#..#####.#.###...###.#####....####...#.#.#...#...##.#...##.######...###...###.##..#.
.######...#....#..#......#.#####.#....####.#....#.##..#.#.#.#..#.##.##...##.#.##.#####.#.###.#..#.#.
#.##..#.#...####....##....#.######.###.##.######...##.....####.#.#..######.###...#.##.#####.###.....
..##.#.#..#.##.#.#.##.##..###..#..#.#.#...##.#..#......#.#######.###.##.#...####.##..###..#.##....#.
.#..#..####...##.###....###....#.#......#..#.###..#..#.###.#.....#.###.#..###..###..#.##.###...#...#
.##....#.#.###......#..#.#..###...######.#..#.####..###...#.##.#.##....###..#..###...##.#.#...#.##.#
.##...#..##.###.###.#....##......#.###.####...##..##.##..##...###.#.#.##.#..#...#.#..###...####.....
#...####.##......###.#####.#..##...#######.##.#####.###.####...##.##.#####...###.###.####..##.#...#.
###...#.#.#.#.###....##..###..####.##..#...#.#.##.##.##....##.##....#.....#...#......##....#...####.
##.####.....#.##.####..#.#....#######.######..##.##.#..###..#.....#..###..#.##..#...#...###.##.##..#
.#..#.#.#.#.####.#..#...#..#.##.#...#..#....#..##....#.##...#.##...#.#..##.#.##....#.#..#######..#..
.#...#.#.#........#.##...####..###..#####..#.#..#.....##...#.####....###.#...###..#####..#...###.##.
##.#.#..#.####..###.#.##.#...##.#..##.###...#.##.##.#####....##...#.#..####.#..#..##.#.#.#..#..##.#.
.#....#..#..#.##.######...#....##..##..#.#...#.##.##.#######..##.##..##..##.#..#.##..####...#.#....#
.#...#.......######...##..#..####....#.#...#..#.##.#.#.#..##.######...#...#.##.###.##..#.####.##..#.
..#.#....##..#..####.##..#..##..#.#.#.#.#...#...##..#..#######..##..##.#..##..#..####.#.#.#.#####..#
##...##.##..##....##..#........######.#.#.#..#.#.#.###...##.#.##..###....#.##...#.#...###.#.###..#..
##......###.#.#......##.#.##.####.#..#...###..##.######.######.#..#####.#...##..#.#..###.####.#.##.#
..##.#..#.#..#..###..##..##.##.#####..#.##....#..#.#.#..##...#.##.##.....##.##....###...#.#.###...#.
###...##.##....#..###...#.##.##.#.#.##.##.###......#...#...#.###.#....##.#.###....#.#.##.#...##.#..#
...#.#.#.#.##..#.#.##.....##.#.#..#...#...##.##..#..##.#####...######..#.##..#.#....###.#.#.##.#..#.
....#####...#.#.##.#...####.......#.#...#.......#.##.....##.##..##...##....###.#.###.....###..######
.###.#...##.#...#.##.##..#.#.######.#..##......##....#....#.....#.#.##.##.#####.#...##....#.........
..#...#..##.#.###.##....#...######....#.#....#.####...#...####.#..#.....####.#.....#..#..#.......#.#
#####..#.##..##.#####.#..##...##..####..###....#....##..#.##...#.#.#.#.#####.#.#...#..##....#.#.###.
..##.#.##.....#.##..###...#.##.#..##...##..#####..#..#..##.#####.####...#....#..##...#.#....####..#.
.##.##....#...#...####.##.#.....###.#...#.#..#..####.#.##.#.##.....#.#.#..#..######.#..#.##.##....#.
.....#.##.#......###.#.#..######..#..#..#####..###.......#.#.##..#.#....####..#..###..#....#.##....#
##.##..##....###.#####...####..##...........##.###..#...#..##...###.#.####....####..#.##.#.#.#.####.
.##.....##..#.#..#.#.....#.#.##....##.#..#.##.#..#.####.##........##..#.##...#.##.#.#.........####..
#..##..#.###.##..#.###..#######.#..#..#...###....#.##..#..###.###.#...#.##.....#......#...#..####...
.#..##....##.#..#..#.#...##.##.#.#.#..##..##...#....###..#.##..#.#.####.#.#.#.#..#.#...#.#..#..#..#.
#####..#.......#.###.#.######.##.###.#.###..###..##.#..#....#...#..##.##.#####..#.#.#.##......#.###.
....##...#.#.##.####.#....##.##.#####.#####.#.#...#.#..######..####.###...#.#...#.#....###.#....##.#
.###...##.#....#..##.######..........#.##..#.#....#.....#.#####..#.#..##......#..#...#.###.#.#.#...#
